1111111111111111111111111111
1P000000000000000000000000E1
1111100000000000000000011111
1000000111000000000000000001
1000011111000000000000000001
1000000000000000000000000011
1000000000000111111100000011
1000000000001111111111000001
1000000000000000000000000001
10000000000000000000000C0001
1111111111111111111111111111
