1111111111111111111111111111
1000000000000000000000000001
100E000000000000000000011111
1000000111000000000000000001
1000011111000000000000000001
1000000000000000000000000011
1000000000000111111100000011
100C000000001111111111000001
1000000000000000000000000001
100P000000000000000000000001
1111111111111111111111111111
