1111111111111111111111111111
1E00000000000000000000000001
1000000000000001000011110001
1000000000000011000100001001
1000000000000101000000010001
100000C000001001000000100001
1000000000011111100001000001
1000000000000001000010000001
1000000000000001000111111001
1000000000000000000000000001
1001001001001001001001001001
1000000000000000000000000001
1001100011000000000000000001
1010010100100000000000000001
1001000100100000000000000001
1000100100100000000000000001
1010010100100000000000000001
1001100011011111000000000001
1C00000000C00000000000000001
1000000001000000000000000001
1000000001001100100010011101
1000000001010010110010100101
1000P00001010010101010100101
1000000001010010100110011101
1000000001001100100010000101
1000000000000000000000111101
10000000000000000000000000C1
1111111111111111111111111111
