1111111111111111111111111111111111111111111111111111111111111111111111111
10000001110000000010000000000000000C11111110000000000000000000000000000C1
100E000000000000000000000000000000000111110000000000000000000000000011111
1000000111000000000000000000000000000011100000000000000000000000000111111
1111111111000000000000000000000000000001000000000000000000000000000000001
1000000000000000000000000000000000000000000000000000000000000000000000011
1000000000000111111100000000000000000000000000000000000000000000000000011
100C000000001111111111000000000000000000000000000000000000000000000000001
1000000000000011111111111111111111111111111111111110000000000000000000001
1000000000000001111111111111111111111111111111111111111111111111100000001
1000000000000000000000000000000000000000110000000000000000000000000000001
1000000000000000000000000000000000000000110000000000000000000000000000001
1000000000000000000000000000000000000000110000000000000000000000000000001
1000000000000000000000000000000000000000110000000000000000000000000000001
1000000000000000000000000000000000000000110000001111111111111111111111111
1000000000000000000000000000000000000000000000000000000000000000000000001
1000000000000000000000000000000000000000000000000000000000000000000000001
1000011111111111111111111111111111111111110000000000000000000000000000001
1000000000000000000000000000000000000000110000000000000000000000000000001
100000000000000000000000000000000000000C110000000000000000000000000000001
100P0000000000000000000000000000000000001100000000000000000000000000000C1
1111111111111111111111111111111111111111111111111111111111111111111111111
