11111111111
10C01001E11
10001000001
10001000001
10001000001
1P000000001
11111111111
