11111111111
10001000E11
10001000001
10000000001
10000000001
1P0000000C1
11111111111