11111111111
10001001E11
10001000101
10001000001
10001000001
1P0000000C1
11111111111
